5,5,5,5,5,5,5,5,5,5,5,5,5,5,5,5,5,5,5,5,5,5,5,5,5,5,5,5,5,5,5,5,
5,5,5,5,5,5,5,5,5,5,5,5,5,5,5,5,5,5,5,5,5,5,5,5,5,5,5,5,5,5,5,5,
5,5,5,5,5,5,5,5,5,5,5,5,5,5,5,5,5,5,5,5,5,5,5,5,5,5,5,5,5,5,5,5,
5,5,5,5,5,5,5,5,5,5,5,5,5,5,5,5,5,5,5,5,5,5,5,5,5,5,5,5,5,5,5,5,
5,5,5,5,5,5,5,5,5,5,5,5,5,5,5,2,2,2,2,2,2,5,5,5,5,5,5,5,5,5,5,5,
5,5,5,5,5,5,5,5,5,5,5,5,5,5,2,2,1,1,1,1,2,2,5,5,5,5,5,5,5,5,5,5,
5,5,5,5,5,5,5,5,5,5,5,5,5,2,2,2,1,1,1,1,1,2,2,5,5,5,5,5,5,5,5,5,
5,5,5,5,5,5,5,5,5,5,5,5,5,2,2,2,1,1,1,1,1,1,2,5,5,5,5,5,5,5,5,5,
5,5,5,5,5,5,5,5,5,5,5,5,2,2,2,2,2,2,1,1,2,2,2,5,5,5,5,5,5,5,5,5,
5,5,5,5,5,5,5,5,5,5,5,5,2,2,2,5,5,2,1,2,2,5,5,5,5,5,5,5,5,5,5,5,
5,5,5,5,5,5,5,5,5,5,5,5,2,2,2,5,5,2,2,2,5,5,5,5,5,2,2,2,2,5,5,5,
5,5,5,5,5,5,5,5,5,5,5,5,2,2,2,5,5,5,5,5,5,5,5,5,5,2,1,1,2,5,5,5,
5,5,5,5,5,5,5,5,5,5,5,5,2,2,2,5,5,5,5,5,2,2,2,2,2,2,1,1,2,5,5,5,
5,5,5,5,5,5,5,5,5,5,5,2,2,2,2,5,5,5,5,5,2,1,1,2,2,1,1,1,2,5,5,5,
5,5,5,5,5,5,2,2,2,2,5,2,2,2,5,5,2,2,2,2,2,1,1,1,2,1,1,1,2,5,5,5,
5,5,5,5,5,5,2,1,1,2,2,2,2,2,2,2,2,1,2,2,1,1,1,1,1,1,1,2,2,5,5,5,
5,5,5,5,5,5,2,1,1,1,2,2,2,2,2,1,1,1,1,2,2,1,1,1,1,1,2,2,5,5,5,5,
5,5,5,5,5,5,2,1,1,1,1,1,1,1,1,1,1,1,1,1,1,1,1,1,1,1,2,5,5,5,5,5,
5,5,5,5,5,5,2,1,1,1,1,1,1,1,1,1,1,1,1,1,1,1,1,1,1,1,2,5,5,5,5,5,
5,5,5,5,5,5,2,1,1,1,1,1,1,1,1,1,1,1,1,1,1,1,1,1,1,1,2,5,5,5,5,5,
5,5,5,5,5,5,2,2,1,1,1,1,1,1,1,1,1,1,1,1,1,1,1,1,1,2,2,5,5,5,5,5,
5,5,5,5,5,5,5,2,2,2,2,2,2,2,2,2,2,2,1,1,1,1,1,1,2,2,5,5,5,5,5,5,
5,5,5,5,5,5,5,5,5,5,5,5,5,5,5,5,5,2,1,1,1,1,1,1,2,5,5,5,5,5,5,5,
5,5,5,5,5,5,5,5,5,5,5,5,5,5,5,5,5,2,2,1,1,1,1,2,2,5,5,5,5,5,5,5,
5,5,5,5,5,5,5,5,5,5,5,5,5,5,5,5,5,5,2,2,2,1,1,2,5,5,5,5,5,5,5,5,
5,5,5,5,5,5,5,5,5,5,5,5,5,5,5,5,5,5,5,5,2,2,2,2,5,5,5,5,5,5,5,5,
5,5,5,5,5,5,5,5,5,5,5,5,5,5,5,5,5,5,5,5,5,5,5,5,5,5,5,5,5,5,5,5,
5,5,5,5,5,5,5,5,5,5,5,5,5,5,5,5,5,5,5,5,5,5,5,5,5,5,5,5,5,5,5,5,
5,5,5,5,5,5,5,5,5,5,5,5,5,5,5,5,5,5,5,5,5,5,5,5,5,5,5,5,5,5,5,5,
5,5,5,5,5,5,5,5,5,5,5,5,5,5,5,5,5,5,5,5,5,5,5,5,5,5,5,5,5,5,5,5,
5,5,5,5,5,5,5,5,5,5,5,5,5,5,5,5,5,5,5,5,5,5,5,5,5,5,5,5,5,5,5,5,
5,5,5,5,5,5,5,5,5,5,5,5,5,5,5,5,5,5,5,5,5,5,5,5,5,5,5,5,5,5,5,5

[Object Layer 1]
type=portal
location=10,9,1,1
exit=9,9
nextMap=alpha

